                                                                          
     +--------------------------------------------------------------+     
     |..............................................................|     
     |..............................................................|     
     |..............................................................|     
     |...+------------------------------------------------------+...|     
     |...|                                                      |...|     
     |...|   +----------------------------------------------+   |...|     
     |...|   |..............................................|   |...|     
     |...|   |..............................................|   |...|     
     |...|   |........+-----------#----#-----------+........|   |...|     
     |...|   |........|           #    #           |........|   |...|     
     |...|   |........|   +-------#----#-------+   |........|   |...|     
     |...|   +---#----+   |....................|   +----#---+   |...|     
     |...|       #        |....................|        #       |...|     
     |...|       #   +----+.......+----+.......+----+   #       |...|     
     |...|       #   |............|    |............|   #       |...|     
     |...|       #   |...+--------+    +--------+...|   #       |...|     
     |...#########   |...|                      |...|   #########...|     
     |...|       #   |...+--------+    +--------+...|   #       |...|     
     |...|       #   |............|    |............|   #       |...|     
     |...|       #   +----+.......+----+.......+----+   #       |...|     
     |...|       #        |....................|        #       |...|     
     |...|   +---#----+   |....................|   +----#---+   |...|     
     |...|   |........|   +-------#----#-------+   |........|   |...|     
     |...|   |........|           #    #           |........|   |...|     
     |...|   |........+-----------#----#-----------+........|   |...|     
     |...|   |..............................................|   |...|     
     |...|   |..............................................|   |...|     
     |...|   +----------------------------------------------+   |...|     
     |...|                                                      |...|     
     |...+------------------------------------------------------+...|     
     |..............................................................|     
     |..............................................................|     
     |..............................................................|     
     +--------------------------------------------------------------+     
                                                                          